>SGD_Scer_YDR044W HEM13 "Coproporphyrinogen III oxidase, an oxygen requiring enzyme that catalyzes the sixth step in the heme biosynthetic pathway; localizes to the mitochondrial inner membrane; transcription is repressed by oxygen and heme (via Rox1p and Hap1p)"
CTTTATGTGTATTTAATTGTGTTCGAAGAGTTCGGTTTGCTATGTTTGATTTGCGAAAAG
AAAGCTTTTGATATGCTCAAAAAAAGAAAACCCGGAGAATAAAAGCTTAACAAAGAAAGA
CAATAGGTGGAAAAAAAAAGGAAAATCCGTGTCCTTATATAGCCTTTCGAAACGAGAACA
ATGGGCAAAGCAAGCTTTATCTTCGGATCGTCCGTCAGCGCTTTGGTTGCAGTCTTATGC
TTTGTTCAAGCTGGAGCGTTATTGGTGGGAGAACCAGAAAAGGCGAAAGCGTAGCGTTCT
TTGAAATTTGGCTTCTGTTCCTGCGACTCGTTTAAAAGTAGAAGGGCCCGCGGAGCCGCT
GTGAAAGATTTCTTTTACTCTTTCAGCGCAGAAATCTCGCAGGAGCTCAGCAGAAAGTGC
CTATGACGGTAATCCCAGGGGCTAATGGTGTGAAGGCACTTTCTAAACAATTGAAATTAA
AATACCGTGCCTATAGTAACTTTTTTTTACGCTGTGAACCGTTCAACACACAGTAAAAAC
TCCGCAGGAAATGGTTTGAAGAATCTTAATCACGAATTAGGCGTATTGTTTTTCCCAACA
GTGAACGAGAGGACAAACTCCAGAGGATTTGCGGGCTTGATGATAAAATGTATTGTTGAA
AAGATCGCGAATGCAACAATTACGGTGGGGAGAAATATCAACAAAAGGGCAAGGCTATGC
CTTCTGGAAAGTGGCAGACTTGCACTTTCCTCGAAAAGAAAAATGACCGCAAGATCCGGT
TGTTCTCAACCTTCTACATTAAGACATACTTCTACGATTTTCGAATGCCGAAGCAACTAT
CGCTGAAATTTGTCATGTCAAAATTGCTACTGGGGGAGAAGAATATATATGGAAGTAATT
ATTATTTACGTTGCTGAAATGGCAGGTTAGACGCATGTTTTGCAAAATAAGTGGTTTTGA
AAAGAATTGATACTAGGAATCGGTGCAATACCTTCTACCT
>MIT_Spar_c130_3912 YDR044W 5' untranslated region, Contig c130 4128 - 6127, 2000 bp (revcom)
CTTTATATGTGTGTTTTGTGGTGTTCGAAATTGGTTTCTTTTGTTCGACTTGCGAGAAGA
AAGCTATCAATATGCTTTCCAAAAAAAGCTGGAGAATAAAAGCTTAACAAAGAAAGACAA
TAGGCGGAAAAAAAGGAAAATCCGTGTCCTTATATAGCCTTTTCGAAACGAGAACAATGG
ACAAATCAAGCTTTATCTATGGGTTGTCAGCTCTTTGGTTGCAGTCTTGTGCTTGGTTCA
AGCTGGGGCATTATTGGTGGGAGAAGCCAGAAAAGGCGAAAGCGTAGCGTTCTTTGAAAT
TTGGATTCTGTTCCTGCGACTCGTTTAAAAGAAGAAGGGCTGCGGAGCCACTGTGAAAGA
CTTGTTGTGCTCTTTCAACTAAGAAATCTGGCAGGAACTCGATATAAAGTGCCTGTGACA
GTAATCTCAGGGGGCTAATGGTGTGAAGGCACTTTCTAAACAATTGAAAATTGAAATACC
GTGCCTATGGTAACTTTTTTTTACGCTGCGAACCGTTCAACACACATTGAAAACCCCGCA
GCAATTGTTCTGAAGAATCTTAATCACGAATTAGGCGTATTGTTTCTCCCAACAGTGTAC
GAGCGGACGAAACTCTAGAGGATTTGCAGGCTCGGTGATAAAATGTATTGTTGAAAAGAA
CGCGAATGCAACGATTGTGGTGGAGAGAAATATCAACAGGGCAAGGCAAGGCTATGCTCT
TTTGGAAGTGGCGGACTTGCACTTTCTTGAAAAGAAAAATGACCGCAAGATCCGGTTGTT
CATAACTTTCTACAATAAGGCATACTTCTACGGTTTTCCAATGCTGAGGCAACTATCGCT
ATAAAATCGCTGCTAGGAGAAGATTATATATGGACGTAAATATTTTTTACGTTACTAAAA
TTCTAGGTTAGAGGCACGTTTTGCAGAACCAGTGGCCTTGGAAAGGTGTTGCTACAAATT
TATGCAATTTCTTCAACTTGCCAGGTGGTCTTGGATGATC
>MIT_Sbay_c896_21290 YDR044W 5' untranslated region, Contig c896 7383 - 9382(revcom), 2000 bp (revcom)
CTTGTTATGTGTGTTTGTGGTGATTGCGGTTTGGTTTTTCTGATTCGTATGACAGAAAGA
AAAAAATTCAGTTTACCTTGTAAGGTGATTAGGAGAAGAAAAAAAGCTTATTGGCAGCGA
ACAATAGGTGAAAAAAAAAAAGAAAATGCGTGTCCTTATATAGCTTTCTCGAAGGGAGAA
CAATGGATAAATCAAAGCTTATCTACGGGTCAACAGCTCTTTGGTTGCTGTCTTGCTCTA
GGTCCAAGCTGGGGCATAATTGGTGGGAGAAGCCAGAAAATGCGAAAGCGTACCGTTCTG
TGAAAAATGGCTTCGGTTCCTGCGACTCGTTTAAAAAGAAAAGGGCCCGCGCAGCCTGTG
TGAAATGTTCGTTTTGCCCTTCCCAGAGAGAAATCTTGCAGGAGCCTCAATACAATGTGC
CTGCGGATGGAATACCAGGGGATAAAGGCGTGAAGGCACTCCCTGAACAATTGAAAATTG
GAAAAAAAAAGTGCCTGTGATGAATCTTATACGTTGGGAAAACTCCAAGACACTTTTAAA
ACTCCGCAGAGATTGTTTGGAGGGACCTTGACCACGAGTTGGGAGTATTGTTTTTTCCTG
GAAGGAACGAGCGGAACTCTTGGGGATTTGCGGGCTCGCTAATAAAAAGTGTCTTGTTGA
AGAAAAGTAGAATGCGACTAAAACGGTGGAGGAAAATATCAACAAGGCAAGGCTATGCCT
TTCGAAGAAAAGCGGACTTGCAATTGCACAACCGTATCGAAGAGAATTGAGAAGGGGGTG
CAAAGTGATCCGGTTGTTCATATTTCTTCACCAATTGATACAATTATCTACGTTTGTTCT
GTTGACCAATCCAACGGGGACTCTGTATGACATAAGTCTTCCTTACATTGCTAAGATCCA
AGATCAGACCCGTAGATGAGTTCTGCACCAAAGAGTTGTTAACCGTCTTGCCTGAATAAT
TTTAAGTTGTCGCGATCCTCTTACAAGGTGTTCTTATTTC
>WashU_Sklu_Contig2357.8 YDR044W 5' untranslated region, Contig c2357 9533 - 11532, 2000 bp (revcom)
AGCTCCAGTGATTTGGGAGTCAAAAAAGGTGTGGTTTTTATAACGCTGTCGTTTAAGCCA
GCACTGCGTACTGTGACGGCTTCTTTTTTTTTTTTTTTTTTTTCTCCTATGTATTTTTCT
TGTTACCAAATCCAGGAAGCTACCATTATAGAGAGCAGCCAGAACCGGAACCGAGTTAAA
TCACCAGATTGATAACAAAGAGATCTATACGAGAGAGGCAGAAGAGCAAAGTTCAAAGGC
ACTGTCGAGGCCATATACTCACACGAAGCTGATGGTAGCGACAATATAAACTATACAGAG
CATACATAGCGCAAAGATTGCAAAAGACCAGGAAACCTTAAACGGCAAGAGTGTAGTACA
TGGCACAGGATACCATCACAACTCACCAGCTGAGAGGTCAGAAATAGGAAGCAGACGAAA
AACAAGAAAAAAGAAAAAAAAAAAGAGCAAGAAATCATCAAATAAAAGCGTAACAAAAGA
GGCTACGTCTTGCAATGCTTTTACACACATGTGAGGAAGAAGAAGAAGGAGAAAACGTTC
TTCCACGGAACGCTACCAACGCACGGCCGGCGTTGGGCTTCCATGTATCCAGCTGCGGAT
GATATCACTGCAGCTGTTACAAGTCTCGTTTCAAAACCAGATATGGCAAATGGTCAAGAT
ATGTGTCTCTGACATAGATGGTCGTTTAGGAAACAACACGCGGCTGTGGTATATAGGGGA
AAAGACACGCATATACGTTGAGTCCCGTACACGGGTACACACGACGAGAAAAGAAAAGGA
AAACCAAAAAGGGTTCTCGGTGGGTGTATGGGTATACAGAGATCACGTGAACAGAAGGGA
TCACATATATCCTCGGCTCGGACGGCATGCTCACGGCCGTTACTCGAGAGAAAAGACAAA
AATAAAAAAAAATACCACCGTGGTTAAAAGACGAAAAAGAGGAAGGGTCTGCTCTTGGCA
CAGAAAAGCTCGCGAGATCCGCCGCGCCCCCCCACCGACG
>WashU_Scas_Contig569.3 YDR044W 5' untranslated region, Contig c569 4575 - 6574, 2000 bp (revcom)
ATCCTTAATTTCTTGATAGAAGATAAATTCAAGAGTAAACAAGGTAAACAATAAAGGTTA
AAAAGAAACGACAAATCCTAAAGGATAGGAGAAAGGAAATATGTATGCTTAGTAAGGTAA
TCGGTGCCCTTTTTATACCTTTCAGTAGAACTGTTGACGTTGAATGGATTCGTATTTTGG
TTCGTCGCAGGAACGAAGTTTCGTCATGTGGGAAATGTCCTCGAGGCCATTTGTTGACGA
GAAAAGTGAAAAAGGGGATATGCCGACGTGGAATTTTGCAACCAGAGAAATGACTTTCCT
GTGAAAGACTCGTAGGACCGCAGAGGTGCTTACGTAGCACATTCAAGATAGGAATATATA
TATCCTTACTAGGTAACCTCCTCAGCTCAATTCGTCCTAGGGGTTTACCTTTACTTAATG
TAGAAAATTTCTTGAAGGTTCAAAGACAGATCTTCATATGGATCTGTCTTTTTTGCATCT
CGCCCATGGGCCTGGACCCTAACGCTGAGTGCAAAAAATCGGAACACTGTGAATGTCTCG
GTGTCAACTAAGTGTTGAGATGCTACCTATGAACTTAGCTGTCAACTGGGGAAGAGGCCC
GAATTATACTCAATTGGTCTGTCGAGAATTTAGTAGTGGATGAGTTGAAGATATTAGATT
AGATAGATAATTCTCCATGTATCTAAGTAAAACCAAAAGACTTACTACTTGCAAGCTGAT
AGTCAGCTAAAACGTCTTGGAAAAAAGGAACCGATGAAATGATCTACACATGACTGGGGT
TTTCATCGCAATTGGTAGCGTATCGTTTATGTAATTGAGAAATATACGAATGGTAAAAGT
AGGATTTACGGGTATTGTAATATTTTTTGAGTTAAGCAACTGCGCCGACAGCATAGCCAG
AAAGGGCGAACACTATGTTTTCGCGTGTTTCATGTCATGTCTAGTTGACACTTACATTCT
TAAGACACCTGACCTAACGTTGGTCCATAAAATTGAAATT
>WashU_Smik_Contig2283.3 YDR044W 5' untranslated region, Contig c2283 2261 - 4260(revcom), 2000 bp (revcom)
CTTTATTGAGGATTTGTGGCGTTTGAGGTTTGGTTTTTTATTCAATTTGAAAGAAGAAAA
CTATCGTTATACTTTCGAAGAAAACACGGGGAATAAAAGCTTAACAGGTGAGACAATAGG
TGGAAAAAAAGGAAAATATGTGTCTTTATATAGCCTTTTCAAAAAGAGAACAATGGTCAA
ATAAAGGTTTATCTACGAGTCGACAGTTCGTTGGCTGCAGTGTTACGCTTGGTTGAAGCT
GGGGCATTATTGGTGGAAGAAGCCAGAAAAGACGAAAGAGTAGCGTAGCGTTCTTTCAAA
TTTTGGTTTCGGGTTCCTGCGACTCGTTTAAAAAAGAAAAGGGCCCGCGGCCCCGCCGTG
AAACACTTCGTCTTGCTCTTCCCACCCAGAAAACTTGTAGGAGCCTCAGTTACAAAGTGC
CTGTAATGGAAATCTTAGGGGGCTACTATTGTAAAGGCAATTTCTGAACAATTGAAAGTG
AAAATATCGTGCCTGTGGTAACTTTCTTATACGCCGTGAAACGTTTAACATACGTTGAAA
ACTCCGCAGGGATTGGTTTGGAAAATTATAGTCACGAATTAGGCGTATTGTCTTTCAAGA
AGGTACGAGCGGATGAACTTCTTGAGGATTTGCGGGTTCGGTGATAAAAAATGTATTGTT
GAAAAGAACGCGAATGCAACAATTACGGTGGAGAAAAATATTAACAAGGGAAGGCAAGGC
TATGTTCTATTGAGAAGCGGCGGACTTGCACTTTCCTCGAAGAAAAAAATGTCTTCAAGA
TCCAATGTTCATATAACTTTCTACAATAAGGTATCCTTCTACGATCTTTCAATGTTAAGA
TTGAAATCAATGTAAAAAGCACCATGTTGAATACTACTGCTAGGAGGAGATCACATATGA
ATGTGATTATTATTTATATTAGTAAATTTTCAGGTTAGGAAGAAGTTATGTGACGCTTTA
GCTTTGGAAATTTGTTGCGGGAAACTGATAACATTCTTTT
