>SGD_Scer_YOR176W HEM15 "Ferrochelatase, a mitochondrial inner membrane protein, catalyzes the insertion of ferrous iron into protoporphyrin IX, the eighth and final step in the heme biosynthetic pathway; Yfh1p mediates the use of iron by Hem15p"
TCTTTAAACGTTCTTTTTTTTACTGCTAAATTTGTCCAAATAGCAGGTATGTGTTAAATA
TTTCTGTACTTCTTGTAAACCGACTCAAGTGGAACACGAGAATTTACGCTTGTTTGGTGT
CAAGCCAAGAGTGACCTTGACCGACCAAAAGTATTCCTTCGCGTCCTCCTTCTTCAATCC
CATATCCCCTACGAAAAAAAGCAGCATGAGAAAACGAAGGGCAGCAACTCCTTCGTCATA
TAAGGCTTACGGTGACCATTGAAGATTGGGCATGTCTAACGGCTATTGCCAGCGGAGATG
TTTCAAGGCATCCTACACATGCTACATATTTGTAATTATTTTACTGAGTTTGTGTATATA
AAAAACTTTTTTAAAAAAAAAAAATGGCCAGCATCCTCTTTCATGTAAAGCTGTTGAACC
TTCCTGAAATTTACTTCTAAAATTGTTCAGTAAAACTGCTTGTTAAAAGTGCGAAGAGTT
CTTTTTTAGCTTTTTTTGTCCTGCTGTTGAGCTGTTTTGCTTTACTGTTCAACAAAACAT
TGAAGATCTTTCACATTGCGCGTCGAAACCACAAACCGTCGAAAACAATGGTCATCTAAA
TAAAGGGTTCTTATTAAACAGATTTAAAGCCAAGGACAAAATACAGGCACAGGTCAAGCA
AGAAGACAAACCGCATACGCCAAGACAAACCGTGGTGATTTAATTCTGCTGCTGATCGCT
TCCAACA
>MIT_Spar_c278_20970 YOR176W 5' untranslated region, Contig c278 32746 - 34745, 2000 bp (revcom)
TCTTCAAACGTTCTTTTCCTACTACTAAGCTTTTCAATAAATAGCGGGTATATGCTAAAT
ACTTCTTTGCTTCTTGTACGACCTACTTAATTGAAATACGGATATTTTTGCTTGCTTGGT
GCCAAACCAAGAGTGACCTTGACCGACTAAAAGTATTCCTTCGCGTCCTCCTTCTTCAAT
CCCATATCCCCTACTGAAAAAAGCAGCGTGCGAAAATGAAGGGCAGCAACTCCTTCGTCA
TATAAGGCTTAGGTAATCTTTCAAGGTCAGGTATATCCAGCTGTCGTTACGAGTAGAGAT
ATTTCAAGCTGTCCTGCACATGCTACATATTTGTGATTATTTTTATTGAGTTGCGTATAT
AAAAAAACAATCTAAAAAAAAAAAAAATGGCCAGCATCTTCTTCCATGTAAAGCTGTTGA
ACCTTGCTAAAATCTATTACTATAATTGTTCAGTAAAGTTGCTTGTTAAAAATGCGAAGA
GTCTTTTTTAGCTTTTTTTGCCCTGCTGTTGAGCTGTTTTGCTTCACTGTTCAACAAAAC
AGTGAAGATCTTTCGAATTGCGCGTCGAAACCACAAACCGTCGAAAATAATGGTCATCTA
AATAAAGGGTTCTTATTTGAACAGATTTAAAGCTCAAAGACACGATACAGGCACAGGTCC
AGAAAGAATACAAAACGCAAACGCCAAGACAAATTGTGGTAATTTCATTCTGCTGCTGAT
CACTGCC
>MIT_Smik_c935_20455 YOR176W 5' untranslated region, Contig c935 1803 - 3802(revcom), 2000 bp (revcom)
TCTTGAATTGCAATTTTCTACTACTGAAGTTACCAACAATTAGCAAATATGTGATGAGTC
CTTTTTACGTTCTTGTATAACCTAAGTTAAATACAAAGGTTTATGCTCCTTTAATGATCA
GACCAACAGTGATCTTGGCCGACCAAAAGACTCCTTCGCGTCCTCCTTCTTCAAGTCTCA
TATCCCCTACCAGAAAAAGTAGCAGGCGAAAATAAAGAGCAACTGCTCCCCCCCATATAG
AGCTTACCATAATTTCTCAAGGAAAGGTATCTCCAGTTGTCGTAAAGAATAAAGAAGTTT
CAACGTGTCCTGCATGTTCTACAAATTTGCAATTGACTTTACTAAGTTGCATATATAAAA
CTTGTATTAGATAAGTTAGCCAGCATTTTCATTCAAGCTAAGATGTTGAATATGCCAAAG
CACATTGCTGAAATTAATCAGTAAAGCTGCTTGCTGAAAGTGGAAATATTTTCAGCTTTT
TTTGCTCTGCTGTTGAGCTGTTTTACTTCATTGTTCAACAAAACAATAGAGTTCTCTCCA
ATTGCGCGTCAAAACCACAAACCGTCGAAAATAATGATCATCTAAATAAAAGAGTTCACG
TTTTCACATATTTAAAGTTGAAATACTCCATACAGGCACAGGTCTAACAAGAAGACAACG
CATTCGATAAAACTAATCGTGGTAATTTTTATATCGCTGCTAGCCACTACCAACAATGTA
CAATTTT
>WashU_Scas_Contig526.5 YOR176W 5' untranslated region, Contig c526 10822 - 11487(revcom), 2000 bp (revcom)
TGTTCTCCTTACTCTTCTGATTGTAGCTTTGAATAAGAGAGTCTCACAACTTCAATTGGG
TATCCTTGGGTATGACGATTCAATTAAAGTGATATAACAAAGCTTTTATGTTTGTGTGCT
TAGTAATTAGACATGGGAAAAAAGACCGTTGTGCAGTGTACAAAGGTCAAATCCGTGATA
AGTGAGAAAAATCCAAAAATTGGCCTAAGGGCTTCCTTAATTTTTTCAATAACCCGAATG
GCTAAAAATCATGGGGGCATCAGGGTAATTTTTATAGGGCGAAAATCATTGATGTAAGCA
GGTAAATGTAGAAGTAACCTTTATTTAGACATATATTATATATATCATTCCAAGTTGAGT
TCCTTTGTTAATCTTAAAGCATCATTTAAAGTACAATCTGTGATATTGATTGACCCCAAT
TTAATTCTAAGTAAGAAGGACCGTATGATACAAAGATCCTCAAACATTTGATCTGAGAGT
TGGCTTTTTCTTTTGTCAAATATTTGTGCCGCCAAGCTGAACAGTCTCTCAGCATGAATC
GATGTCGATGGAATACAATGGAATAATTTATTAGCTAATGATAACAGTGGAAACTCTCTT
TTATGCCTTGACCAGAATATATTATCTGCCCCCACAATCATCTGGACTTGGCGGTCGAAT
GGCGAC
>WashU_Skud_Contig2050.4 YOR176W 5' untranslated region, Contig c2050 12271 - 14270(revcom), 2000 bp (revcom)
TCTTAGTTTATAGCTTTTCTACTACTCTGGTCATAAACGAACAGAAGATAAGCAAGAAAT
CTTTTTTTCCTTCTTTTACGGTCTATTCAAGTGAAGCACGGGGATTCCCGCTTGTTTAAT
AATCAGACCAACAATGATATTGACCGACCAAAAGAAGTATTCCTTCGCGTGCTTCTCCTT
TCTGTGTCAAATCCCCTACTGAAAAAGCAGCATTGGGAAAGGAACAGCAGCTTCTCCTTC
GTCGCAGAGAGCTCGCGGTAGCATTTCATTGTCAGGTATTTATGATATTTGCTAAGAATA
ATTAAAATGTCTTCAGGTCTTGCACATACTCCTACATATTTGTAAGTATTTTACTGATTT
GAGTATATAAAAGCCGTACTAAAACTAACCAGCACCTGTAGCAAGGTGCAAAATGTTGAA
CCTTTCCGAAATTTATTGCCAGAAACCAAGAGCTAAAAGTGCTTGGTAAAAGTGAAAAGA
CTCTTTTTCAGCTGTTTTTTGTTCTGCTGTTGAGCTGTTTTGTTCCATCTGTTCAACAAA
ACAGCTTCACTGGATCTTTCAAAGTGCGCGTCGAAACCACAAACCGTCGAAAATATTGAT
CATCTAAATAAAGGGTTCTTATTTGCACAGTTTCGCATTGAAATATTCCATTCAGGCACA
GATCAACAAGAAGACAAAAAGGTATTCGAGAAGACTAATTGTGGTATTTTTACTTTGCTG
CTGACCA
>WashU_Sbay_Contig480.2 YOR176W 5' untranslated region, Contig c480 3444 - 5443(revcom), 2000 bp (revcom)
TTTCAGGGAAGCACCATGTGCACGAATTGTTCTAGAAAGCATTTTTGGTTCGTAAATTCT
CTACAACTGAACTTATTAACAAATAGCAAACAGAGAAGAAAATTTTTTTTTTCCTTCTTG
TATGGTCAGTTAGTTGAAAACACGGAGATTTTCACTTGTTTAGTAAGCAGAGCCATAATG
CTCTTGACCGACCAAAAGAAGTATTCCTACGCGAGCTCCCTCTTCAAGTGCCAAATCCCC
TACTGAAAAAAGCAACATGAGAAGCAAAGAGATGCCTCTCGCCATGCAGGGCTTGCGGTC
ATGTTTTCTACGTTCAATTGATTTTGTTACAGCTGAAAGATGTTTATAAAACTGTCTTGC
ATATGCTCTATTTACTTGTAAACAATTTTATTAAGTTGCGTATATATGATCGTACTAAAA
ATTGGCTGGCGCGTTCTCCAGGCAGAGTTGGTTGAACCTTGCTCGAATTGATAGCTCAAA
GTGGAGAGACTCTTTTTTAGCTGTTTTTTGTTCTGCTGTTGAGCTGTTTTGCTCCACCTG
TTCAACAAAATGGCAGAGATCTTTCGAAGTGCGCGTCGAAACCACAAACCATCAAAAATA
TCGACCATCTAAATAAAGGGTTCTTGTTTGAATAAATATCAGGCGAAGCTCTTCATACAG
GCACAGGTCAGATAAGAAGACAATTCGAATTCGAGAAGGATATTCGTGGTATCTTTAATC
TGCTGCT

