>SGD_Scer_YDR047W HEM12 "Uroporphyrinogen decarboxylase, catalyzes the fifth step in the heme biosynthetic pathway; localizes to both the cytoplasm and nucleus; activity inhibited by Cu2+, Zn2+, Fe2+, Fe3+ and sulfhydryl-specific reagents"
AGCGTTATAACCTGTTCTTTGCTTTATTTTTTTTTTTTTTGTTCTTCCTTTTCTCGAAGA
GAGCTTACCAAACACAATTCTGAGATAATGCTTGATGAATTGAAGAACCTATCGATCACT
CTATGTTACCTTCGTCTGGAACATCACTAATTCGAGCGGTAAAGATGAAAATGGCAGAAC
ATTTCGCTGGCAAAATTAAAACTCTTGCCTCATTTTTTTTTGCTTTCCTCTCCTGCCGCC
AAAAACCCCGAACCCTGTCCTGTATATACGAGAAACATTGAAAAAGATCGTGTATGATAG
CGCCAAGATGGCGGATAAACTAACACTATTGACAGGTTGAGGCCAAGGATATATTACTTG
CTAACAGAAAGAGATACTGTCACCACAATTGCCCGCGTACGTATACTACAACATGTTCTC
TATATATCACCCACTCTTTCGCAGTGCTACGTACGCCAAAAACGCGCGCATGGAAGTAAA
GAAGTTTTTTCTTTTAAGAGCGAAGCTCCATTAAAAGCCTTGAATATAAACTAGTGCGAA
GTAGTATGATCCGAAGACACCAATTGCTGGTGCAGCATAGGAATATGTGGCGTCCGAAAA
AGAGCCTTTAACAATCCACGGCGAAACAAGGCACCGCTGTGCATTTAAAACATGCCGTTC
CCGTACCAAGTTATATTGTTACGGATGAATCCAAAATAATTTGTTAAAAAATGCTGCCGT
TCCGTCCCATTGAGTTTTATTTTCCTTCTCATGGCACCTTCTTCGTTTCTTCATCCTGCA
TTAGACTTACTAGTGTGCTTGCCGGATGCGTGCTTTTTTTTTCCGGCCGACACATATCGC
TGAGCTGGAAGGACACCTTTTAATGTAGCCGTGCATGCGGCTCCGCGAAAAGAGCTCTGC
TATATTTCTCTACCTGAACTTCGAGCCGCGATCAACGAAAGCTCTCATCCAAGGCTCGTT
TTTCTTGACAGAAGCATGACAGTAAAATATGCGGTCATTT
>MIT_Spar_c130_3923 YDR047W 5' untranslated region, Contig c130 9341 - 11340, 2000 bp (revcom)
AGCGTTATGATGTGTTATTTGCTTTTATTTTCTTCTTTCTTTGTCTCGAAGATAACCTAG
CAAACACAATTCTAAGAAAATTCTCGATGAATTGGTTGTCAGCGCTTCCTATTTACTCTA
TGTCCACTTCGTTTGAAACATCAGTGGTTCGAGCAGTAATGACAAAAAGGGCAGAACATT
TCGTTGGCAAAATTTAAACTCGTGCCTCTCATTTTTTTTACTTTTCTCTCCTGCCACCAA
AACCCCGAACCCTGTCCCGTATATACGAGGAACATTGAAAAAAAATCGTGTATGGTAGCG
CCAAGATAGCGAATAAACTATCAGTATTGGCAGGGTGAAGCTAAGGATATGTTGTTTGCT
AACAAAGGGAAATGCTTTCGTTATAATCGCCCGCGTGCGTCTACTAAAATATGATCTATA
TATACCACCCAGTCTATTGCAGTGTTACGTACATCAAAATGCGCGCATGTAAGTGAACAA
GTTTTTTTTGTTTAAAGAGCGATTTTCCAATAAAGGCTTTGGATATACACTGGTGCAAAA
TATATGGTCAATGACGCCAATTACTGGTGTAGCATGAGAATACGTCGTCCGAAAGAGTTT
TTTTTTACAAACTACGGCAAAGCAAAGCACCACTGGCGCAATTCAAAACATGCCGTCCCC
GTACTAAGTTATGTACGTTATTATGGACGGATCCAAAATTATACTCTAAAATGCTGCCGT
TCCGTCCCATTGAGTTTTATTTTCCTTCTCGTAGCACCTTCTTCGTGTCCTTTCCTTCTT
CTGCATTAGGCTTACTAGCGTCCTTTCCTTGCCGGATGCGTGCTTTTTTTTTCCGGCCGA
CAAATCTCGCTGAGTTGGAAAGACACCTTTTATATAGCCGTACGTGCGGCTCCTCGAGAA
AGGCCCTGCTATATTTCACTAGCTGATCCTCGAGCTGCGATCAACGAAAGCCCCATCCAA
AAGGCTCCTTTTTCTTCAAAGAAGCATGACAGTAAAATAT
>MIT_Sbay_c896_21277 YDR047W 5' untranslated region, Contig c896 2230 - 4229(revcom), 2000 bp (revcom)
AGTGTTAACAGTATCTTTTGCCTTTTTTTATTCTAATAGCTACCCCAGGAATCACTATTT
AGCAAAGATCGTTTGCAAATTGGCCGTCAGTACGTTCTAAGTTCTTTAGAACATCATTGG
CTCGAGCATTAGTGACACGAATAGGAAAGCATTTCGTTGACAAAAATAAAATTGTTTCTT
TATTTTTTCCCTCTTTTCCATGGCGTCAAAAAACCCCGAACCCTGTATAAACGAGGAAGC
TGCATGGTAGCGCCAGAAAAGGCAGATAACCTTTAACAGTGCTGACAGAACAACGTCAAA
CATGTGCGGATAATGCCTTCGCTGACGGCAAGAAATTATATACGCCTCGAAACTGTAGAA
CGTCTTTTGTGCCGCTTGGTAACAAATAAACCTAGCCGGGGCCAGAATTTCACCCGTACA
TACTTACTGTTACATACTGCATGCACGCTACGCATTCTCACCGAACATCGAATCTGCCTG
CAGAAGCGAAGAAAAGCAAGTCTTCGAAGAGCAAGCTTACATCCATCGTGTTGAACACAT
ATGCCCAGCAAAGGGATCGGATGACGCCCAACTAACATTGGAATTTGTGACGCAAGGCTG
AAAGGCACTTCTCTATAGCCCACGGTGAAGCCTTACGCTATTGACAAGACAAAACATGCC
GATCCAAGCCAGGCGAAACGGGCCTAGCACTACGCAGCCAAACACTGGCGTTCCGCCCGT
CCCATCCAGTTTCATTTCTTATTTCGTTCTGCCTTGGGCCTAGCAGCGTGCTTGCCGGAT
GAGTTTTTTCCATTTTCCTACCGGCTCATCTCGCTAAGCTGAAAGGTCAGTTTTATAGCC
GTGTGCGCGGCATCGAGAGACAGGTTCAGCTAATGATATTTGCCTAATTCTCGAGCTGAG
GCCAATGAAGGCAGCTTCCAGGGCTCGTTTCTGCTCGGGAAAAAGCATACCACACATTTG
CACGGCTTTTATGTGCCATAGTGCCACCACTAGCCCCCAG
>WashU_Skud_Contig1362.1 YDR047W 5' untranslated region, Contig c1362 1 - 761, 2000 bp (revcom)
AGTGTTGATGGTATCTTTTGATTTTTTCTAGATTGGTAGCAAGCTCAATTGGCACAGCTC
TAAAAAAAGCCTTGTGAATTGGATAGTACCTTCTTTCGTTTGGAACATTACTGCTTCGAG
CAATAAACATACGAAAGGCAGAACACCTCGTTGACAAAACTGAAACTATTTCTTCAATTT
TTTGGCCTTTTTTCCTGCTGCCAAAAAACCCCGAATCATGTAGAAGCGAGAAGTAAAACA
GAGGAAGTGTATGGTAGCGCCAAGGAAAACGGGCAATACTTAGAAAGAATGACAGAGCTC
AGCCAAGTGTAAGCTAAGTGTTGACAAGGGAAGGTACATTGGGCCCCGAAAAAATTTGCT
AATGCTCGAAGAGCTCTCAATCAATCACCCACATATATGTACTACAGTATATTTATACTT
TCCACGCAGTCTCACGCAGTGCCACCTTCATCACCATGCGTGTAACTAATCGAGCAAGCT
GTTTTACGAAGGGCAGCTTTCCTATAAGCGTTTTGAACATGCATGGCTGCACTGCAATGA
GATCAGGCGACTCCAATTCCATAGCCTAGCACGGGATTAAGTAACGAGAAACTGAAAGAG
ATAATTTTACAAACCCGGACGAAGCAGAGCACTTGCTGGAACAAATCAAACATGCCGTCC
CCTACCAGCTCTCGAAGCGGGCCTAGCATTACTCGATCGAACGTTGCCGTTTAGTCTTAT
TTTCCTTTCCGTGCTGCGCTGCTTTTTTCTTGCATTGGGCT
>WashU_Scas_Contig569.6 YDR047W 5' untranslated region, Contig c569 10116 - 12115, 2000 bp (revcom)
TTTTTCAAGTCGTTGGGTGTCAAATAGTGGGAGGATTGGTGGAGGAAACGTGGAACAAAT
GATGACTGTTTCCTTTTAAAGGATATTCGCCAATTGACAGCTACCGTACGATTCGGTTAA
CGTTGCGGCTCGCGCCAAATATAAACGAGCCAAGAATGTCAAATAACGCTACGTATCAAT
TAACGTCACCTATCAATCTTTGTAAATTGATAACAAAATACATTAGTGATTACTTCTCCA
ACCTTTATCAAACCATCAAATAAAGTCCTTAAATATGTTGTTCCCCACAAAACGGAAATT
TAAGGGTTGAGAAGGAAGTGTGACGGTAAAAAGATTCTTAATACCTTAGTATCGAGTAAA
CGAGGACGAAAACGAATAATCTCCAGTATAAAAAAACCAATAACTCAGTTATAATATACT
TCCAAAATCATTTTTATTTATTTTTGAATAAAAATATATACGAGAGGTGGAGATGACATA
TTATCGCTTTTACAGTAAGTTTTTCTTCCCTTCTTGATTTAGAGAGTTGTGAGAACAATC
TGACGTTTTTCATAAGAGGTTGATTCAATTACGTTGTTGTCAATTTAGTCATGAATGGAA
TATCCATATTCACATCCACCAACCTCTGAGCTACAATAACATTTCATTTACAATCCAGCC
TCGAGGTGCTGTGGTGAGGCATAGCTTATAGTTAAAGTTAGATTCCATTATTCATTTCTT
ATCAAAAACAGACATGACAATTATATTAATATTAAGGCAAAAAAGAGTGTCAAAGTTCTA
ACTGTTTTTCCTCAAAAGTTAGTGGAAAAAAAAAGTTTTCAAATATTCTTCACATAATTT
TTTTACACATGCTTAACCGCTCTTAAGACTGAACTAATTCGTCCTACATTACAATGATAC
TTGTCCAATGACCTTCTTTTAAGACTTTTTGTTTCATGTGAGGGTTTCTTCTCCGGTTTA
AAGGCCAGGAAGTCTAAAAAATTATATTGAGGAACTATGG
