>SGD_Scer_YGL040C HEM2 "Delta-aminolevulinate dehydratase, a homo-octameric enzyme, catalyzes the conversion of delta-aminolevulinic acid to porphobilinogen, the second step in the heme biosynthetic pathway; localizes to both the cytoplasm and nucleus"
GGTTTTGTCAATTTTCTAGGTATGAATTACTGGAGTAAGCAATAATATGAGTAAGCAGTA
AAACTTTTTTTTATTTGGCTGATTGGGCAAGAAAATCAAAGACAATAGAGTGGCGCATAG
ATGTTGCTAGCATTTATTAGGTTGCCTTACTCTTATATAAATCAAGCGGGAAGCTTGCCT
CAAGCCAATCACCGCACCGAACAGGGATTGCTCGTTTACCCGTATTTTGATTTTTTTTTC
ACCTTTTCCAATTTTTTTTTCGGCAACAATTTTTTGGATGATTTTTATCGTCGATCTTGG
AATGATGATGTATTTCGGCGTCTCTACAAGACCCAATAAAGTAATTCGGTGACACAGGCT
TGTAGCAGATAGAAAACGTTCCGAAAGATGGGTTCCAATTGATGTAACACTTCTTTTTTA
TATATTCATGTGGACGTGTACGCCTTCTTCCCTTCTTTGCCTCTTGTGCCACTGTTAATC
CTCTTAAGCATATTGTTTTTATTTACAGACATTGGCTGACTCACCAGAAACTATAATTGA
CGCTGATTTCTAGTTAATTAAAAATAAAATATATGCAAGAATTAGCACCAGGCAGTCATT
TCTGTAAATTGCTTTGTTTTCTATTTCAAATTTGTTTTTTGTATATGTTTCAATGTTCTC
GTGACAATGCAGGCTTTTTTTTGTGCGAATTAAAGTAAAGCTAATCAAAACTAAACAATA
ATTTATCTTGTTCCCGAAAGAGTGGATCATGAGGAGGAAAGCTAACCGTCCAAGATCCTA
TATAATTTTTGAACTGAAAACCAACTGTTCACCTAGAAGACAGGTATCTGGATATGTAAC
TACACGCTCTATAAATACAGAAATCGTAAGCTAATCAATATAAATGTAAAAGAAAATAGG
AATTGCTGTCGATAGATTTATTTACTTTTGTATTGTCATCTGTGTTCTGTGCCAGTACAC
CGGACTCGTATGAGCTGTATGGTGTCGTTTCAATAGAATC
>MIT_Spar_c19_8512 YGL040C 5' untranslated region, Contig c19 1 - 1802, 2000 bp (revcom)
GGTTTTGTCAATATTCTAAATATGGATTCCTAGGGCAGGCAATAATATGGGGAAGCAGTA
AAACTTTTTGTTTTATGTGGCTGATTGGGCCAAAAAACAAGGACAATAGAATGACACATA
AAGTTTGCTAGCATTTATTAGGTTGCCTTACTCTTTTATAAATCAAGCGGGCAGCTTGCC
TCAGGCCAATCACCGCACCGAACAGGGATTGCTCGTTTACCCGTAGTTTGAATTTTTTTT
TCACCTTTTGAAATTTTTTTTTTTCGGCAACAATTTTGAATGACTTTTATCGTCAATCTT
GGGAGTATACCTGCCTCTTTACAACACCCAACAAAACACTTAAGTAAGACAAGCTTGTGG
CAGGTAGGAAAGGTTTCAAAAAAAAAAAAAAGGTTTTTATCTATGGTCATACTTTTTCTT
CGTATATTTATGTGAACACGTACGTCTTGTTTTGCCTTCTTTGGCTCTTGTGTCACTGAA
TCTTCACATATTGTTTTTATTTACAGATACTACTTGACTCGCCTAAAATTATAATCGGCG
ATGGTTTCTACTACCTTAGTTAAAAAATAAAATGAATCAAAACATTACCATTAATAATTC
AATTTTTCCACATTAGTTTGTTTTCTATTTTATGGCTTTCTTCTTGTATATTTCTCAATA
TACTGCATGGCAATGCAAGCTCTTCTCTTTTCTTGATTGAAAATAAAGCTGTGAAGAACT
AAATAATAATTTATTGATGTCCTCCACAAAATGTACACCTGCGCTAACCTTGCTTAACAG
ATACGGTCAAAACGAACTTGAGCATATGTAAAAATCCATGTATTTTTCTTCTTTTGCCAA
CTAAATCAAACTTTTTATTGTATATGTCGTACCGCCAATACAAAGATGGAGAGGTTAATG
AAAATAGATGTGAAAAAAAAGCAGGAACTATTGTAGATAGATATTTTTAGGGTTCGATTG
CTATTTTTCTGTATTATGATCTGTGTTCTATGCCAGTGTA
>MIT_Smik_c273_7756 YGL040C 5' untranslated region, Contig c273 1 - 1807, 2000 bp (revcom)
GGTTTTACCAGTTTTCTTAATACGGATATCTAGAGTAAGTCACAATTTAAGGAAATTGCA
AAATTTTCTTTTTATATAGCTAAATAGGCCAATAAATCAGGAACAATAGAATGACGCACC
GAGTTTGCTAGCAACCTACACACTTGCTTTTTTTTATAAATCAAGAGTGTATGTTGCCTC
AGGCCAATCACCGCACCGAATAAGGATTGCTCGTTTACCCGTTGTTCGATTTTTTTTTTC
ATCTTCTACCAATTTTTTTCGGCAGCGCCTTTGAATGACTTTGATCATCAATCCTGGAGT
AATATACACTTGTATGTTTGAAACGCCCAGTTACAATATTTATTGGAATAGCTAACTTAT
GAGTAAGTGGACCCAAATTTTCGAGTGATGTTTCCTGTCAACGGTGACACTTATTTTTGG
TTTGCAGATATGTATGTGTATATCTTATTCCCACTTTTTTATAGTTATCGTTATCTATGT
ATCTCAATACCTTGGACATGAATCACCGAGTAGATATTTTTCTTTACAATGCTTAAAACA
AGGCCGCACAGAACTAAACAATAAAGTTACCTTGATCTTTAATAAAATATTCCCCCATTA
ATAAGTACTCTCTTCGATTACGATTTAGCCATATTCATTTTGACCATACATTGCAGATGT
GAGATGGATTTTAAGTGGTGAAAGCGCTCTAAGCTATGCCATATAAGTACGTAAGGAGAG
ACAAAATTAAACATAATTAAGCGCCATGTGAGACTAAATGTGGCCGTCGTTTTGATTATA
TGATTGGGAAAAGCTCCTAAACATAGAGGTAGAATTATAGTTCGGAAATTTCGTCTTGCC
CTGCTCATTTTGTAGAAAACGAGTCATCATCTCCACCCTTTGTAACCGGTGTCCTGCTCA
CATAAATAGTCTCTACTGAGAGATTTGTGAATTTCGAGATAATTTTTGGGATTCCATTGT
TGATAAAGGCAATATTATTAGGTATATAAAATATACTAGA
>MIT_Sbay_c77_8808 YGL040C 5' untranslated region, Contig c77 1 - 1377, 2000 bp (revcom)
ACTTTGTCAGTGTTTTTCTGGTAAGGATATCTGGAAGAAGTAACAATACGTATAAATTAC
AAAATTACCGTTTTATGTCGTGGAATGGGCTATGAACTAACATTAACAATAGAGTGATGC
ATAGACGTCACTAGCCTTTTATTGTGTTGCCTTGCTCTTTTATAAATCAGGCAGCCTGCC
GCAGGCCAATCACCGCACCGCCCGGAGATGCTCGTTTACCGTTGTGCACCAAATTTTTCA
TTTTTTGCCTTTTTCTATTTGGCAGCGTTTTCGAAAAATTTTGATCATTAGTCTTCAATG
ACTGGACTGTCATATTTTAGGGCACGCAGGTAAAGATATGAACAAATCATATTGATGATG
GATGCCAATCCTTCAATGTAAATTCTTTCTAAACATCATGATAAAGAACTTCAGTAAGAG
AGTGATAAAAACTTTACATGTATGGCGGGTGTATTCTGTAATTGTTTTTTAGATCTTTTT
GTTGTTAACGGTGACACCATTCTTACTACAATAATTGCATGTCAAATGTAAATATCTTGC
TTCACATTTCGTTGTTTCTTTACGATAAATTGTTTCGTCGCAAATATATCTTATTTTGCG
TGGTTTATCTACAGACACTGCTTGATTTACGCATAAGTACATCATGTAGTAATTCTTATA
TTGAGTATAAAACCATATGAATAGAAATATTTTTGTTAATCTATCGTTAATTTACATGCT
AGTTTATTTGTCCCTTTAAAATTTCTTTATATATTTGTTGCAATATGTGGACAAGGAAAC
ACGAAATATATTGGGATAAAGTTTAAGTAGAGATACATAGAACTAAACAATAAATTCATA
TTCAATAATACTTCAAAAGGTACTCTCCTGTCTGAACACAGAGACTCACAGACTTTATTT
AGTCGTTATGGCGATGTCAGACATCATGTTTAAGGTAAGCCGAGTGGATTGATATGAAAT
TGTCATATCATGAATAAGCTAATTACCCAAAAACAGTAAA
>WashU_Sklu_Contig1444.1 YGL040C 5' untranslated region, Contig c1444 1328 - 2770(revcom), 2000 bp (revcom)
TGGTTTGACAATAGAAGCTTTGATACTGAACTATGATGAAAGCAGCTTGAAATGTAGCCA
ACAATAGTGGTTTTGGTTGTAACAAATTTTTCACCCAGATATGCGTTTCTTTTAAACCAA
AAAAAAAAAAAAAACCAAAAAAAAAAAAAAAAAGAAAGTTGTGATTAACTTAGAGATGAT
GTAGAAAAGTAATCTACGATTAGCAATTGTAGAGCGTAAGAGGTAAAATACAAGCATGTC
ACACCAATGCGAGGATGAGCATCATTCGCACAGACACTCCCCACCACCAATTCCAACCAG
TTCCAACCAGTCTCTGTACCAGTTCATTGACACTTCAAAGTTACGCTGCCTGAATGTTAC
AAGTAATGGTGCCAATCAGTTTCCTCCATGGTTCATAAACCCTCAGGACCAAAAATACGA
CGTCTCAAAGTACTTAGAGAGTGATGCAGATTGCCAAATGCTGTTGCATATCCCGTTTAC
CGGTGATGTCAGAATATTCTCCCTTATTCTAAGATGCAGTAAGGCGGAGGACGGATGCGG
GTCCCCTAAGAGTATTAAGCTTTACAAAAATTTCAACAAAAACACCGATTTTGAAACTAT
CAGCGATTCCAAGGAAAGCTACCACGTGGAAAGCCCAGAAGATGTTGGAATTGCTAGCGA
TGGGAGCGTGAACACAGTAGAAGACGATTCCACCTTCGTAGAACATCATCTTCCACGCCA
CATCTTCCAAAACTGCAATTCAATAACGCTGTTCTTTGAAAACAACTGGAGCGAGGACGA
AGACGATTTAACCAGATGTTACTACTTAGAATTGCGTGGCGAGTTCACTGCTAAACGTAC
ACCGCACGACGGGATGCCACAGTTAGCCGTCTACGAGGCTGCTCCAAATCCGGCGGATCA
CCAGAAGTTAGAGAATGAACAAGAATCTGCAAGTTTAGGCATGTAGGAAGAAATCTACGT
AGAAAACACAACAAAAAAAAATTAAAATTTATAAACGAGT
>WashU_Scas_Contig575.11 YGL040C 5' untranslated region, Contig c575 17052 - 19051, 2000 bp (revcom)
TGTTGGCGTCCTGTTTAGTCAATGTTAAAAAGGTAAGAGTTTGTAAAGTGTATAAGTCAA
GAAAGGGACTGTGAAACAATATGTTGAATGTAAGTTGTCTTTTATAATCCTAAGTGAAAT
TCCACCAACCAGGAACGAGCGGACATTTAAAGTTAAGGGAATGCGCCGTCGCTTCGTGGA
ATGTTAATGACACGTTTTATTTCATTTATTATAATAAAAAAACAATCAGATTGATTGTTG
CCCCATTATCCAGGTTGTTTAAAGAAGAGTACTGGATATAACTCTGTTGAGCTGATTTTT
CTATTCAAAATGATTAGGTAGCCTCCTTTACATAATTTTTTTTGGCGCAAACACCATGGC
TGAGACATTTGAGCAAATATTGATAATATTTTAAGAAAGAAAACAGACATATTGGTTCAA
CTGCAAAAGGTGCCTAAGAGGAGCAAATACTGCTCAAGAATACTAGTTGCAATTACAAGC
GATCAAAGATTTAATTCAAGCGTTGGAATATTAGCAACCTTTACCTGTATGAACCAACAT
TTTAAAGTTTGATAATTATTTTTAATCAATTTTAGTTGAAAAGTTATATAAAGTTCTCCG
ACAAATACTTGAATGACGTGCCATGTCTAATTTGGTTTAAGGTAGCAATATTTAGTTTTA
TTTTGGTGATATTCTAGAAAGTATTTAAACTGAAAAAACTAATCAAGAAATGAAAATTCA
AATATTCAAGAGAAAAAATAAATATTGTCTTAAATTTCTTATTTTCTCGACCCAAAAACC
GTAACTATACTTACCATTTACTTTCCTTGATCAGAATCAACTATTCCCCATACAAAGTAA
ATTAAATACTCAACTAATAATGGGATGACGGCATGACCGATTTTATGTAATAAAATAGGA
GCTCTAAACAAATTTTTTCACATTAATATGGTTGTTTGGCCGAGCGGTCTAAGGCGCCTG
ATTCAAGATCAAACATTCTTGACTGTGGAACACCACAGGA
>WashU_Skud_Contig2052.17 YGL040C 5' untranslated region, Contig c2052 29967 - 31966, 2000 bp (revcom)
GATTTGTCAGTGTTTTCTGATATGGATGCCTGGAGAAAATATTAATATGTGGAAACCACA
AAACTTCCACTTATATAGCTAATTTAGCCAGAAATCATGAACAATAGGATGACGCATAGA
CGTCACTACTCTTCATATAAGTTGCCTTTCTCTTTTATAAATTGGGCAGGCAGCTTGCCT
CAGGCCAATCACCGCACCGAACAGGGATTGCTCGTTTACCCGTTGCGTTCAAAGTTTTTC
ATTTTCCGCATCATCTACTTTTTTTTTTTTGACGCCGTTTTTGAATGTCTTGGTCATTGA
TCTTGAAATGATTTATGTTCGTGTTTTCACGGCACAAAGGTAGGCAAATCGGTAAATTTT
ACTCGTAATAAATAATCAAGGCCTCTAGAGGATTTAATATCAGGAAATAATAATGTGAGT
TTTTTGCAAATGGCCTTATATTCCTGACATCTTCTTGAATTTGTGTTTTAGCGTCGATGA
AGACTCTTCCTTTTTTCGTACGGTAATCTGGACATCTTGTTTCGTCTTTTCTTTTTTTTT
TGCGATTGCTTGTAATTCCAGATATGCAGCATTTATTTACAGGTGCTGATTGATTTACTA
TAGAGTTTATCAGGTAGTAGTTCTTTTTCATGTCTCAATTGAAGAAAAGGAACCCATAAA
TACATTAGCACTGAACAAACAATAACTGCCGCATTGGTTTGTTTTCTAACTTGAATTTTT
CTTTATACATATGCCACTGTATTAGGATGGGTGAATACCGTTTTCTTACTTTCTTCCTAT
GAAGGCGAAAGAATGGTGAAGGACAACTAAACAATAAATCGTTTTTCACACATCCCCATA
AAGCTTTCTCTGTTTGTCAGTTGTGACTCATCTTTCGTCGATGTTGCTTGGTAGATACAA
TTGAACAAGATTGAGATATCTAAAATGTTCAAAAATTATACTCTCTTATGTAGTTTCCGT
CATGGCTGAACGAAGGAAAACTACATCACCTGAGAATTAC
