>SGD_Scer_YOR278W HEM4 "Uroporphyrinogen III synthase, catalyzes the conversion of hydroxymethylbilane to uroporphyrinogen III, the fourth step in the heme biosynthetic pathway"
CTCTCGAGCAAGGTCTATTTTACCTTTCTGTTTCCTTATCCTTTGACACTAAAATTCAAA
AAACTCACTAGAAAGTTCACTAAAGCGCCTTAGCTGACTACAGCACAACCCAACCCCAAA
AACTAGTGAACTACACACTAAGAGAATTTATGGTATTTCCATAATTGAAGTATATGTACG
ATGTATACAATGTAAACAAGAGAGTAATGAAGTGAAGATATGTACACCTAGAGCGAACCA
ATGATAATTTGTTTTCTTAATTAAGAAAAACCATTAAAACTGGATTAGATTTCAATAATG
AAAAGCTAGGAACAAAAAAAATTGGTCTACTTCCAGCCATTTGCGCTTTATATAGACATA
TGGAGGCGTGATGTCTTAAGCATGGTAATCCGGAAGATCAGTTTATTGAATGATGGTTTT
CTTATCCTGAAGGATCCTGCAAATGAAGTAAGTTCAAAGAATTGAAATGAAATCGCCTTT
TATACCCTCGCCGCACCAAGGAGCGCGCTGTGAAAATTTTTCGCTTTATCTCTTAGGGCT
CCTACTGTCGGTAGAGAAAAGTTGAGTATATTTAAAGCATGAGGTAACTTTTCTGCCCAT
TTTTACTTCTATTTCCATTTGAATTCAGAAAAGTG
>MIT_Spar_c261_21317 YOR278W 5' untranslated region, Contig c261 32269 - 34268, 2000 bp (revcom)
CGTTCCAAGCAGGGTTTATTCTATTTCTCGGCTCCTTTACCCTGTAACTTCGAGATTCAA
AAACTCGCTATAACTTCACTAAAGCGCTTTAGTTGACTACAACACAACCCAACCCCAAAA
TAAACTGTCCAACTACACAATACCGAGGATAATCCACGATATTTCGGTGATTGAAGTATA
TGTATTACGTATGCAATGTAAGCAAGAAACTAACAAAATGAATATGTACACCTAGAGCGA
ACCAATGATAATTTGTTTTCTTAATAAAGAAAAACTATTAAAACTGGATTAGATTTCAAT
AATGAAAAGCTAGGAACAGAAAAATTGGTCTACTTCCAGCCATTTGCGCTTTATATAGAC
ATATGGAGGCGTGATGTCTTAAGCATGGTAATCCGGAAGATCAGTTTATTGAATGATGGT
TCTTTTATCCTGAAGGATAAACGGAAAGCTCCCGATTAAAAACAAGTATAGAGTACTGGA
ATAGAATCGCCTTTTATACCCTCCCTCGCCGCATCAAGAAGCGCGCTGTGAAAATTTTTC
GTTTTTCTCTTAGGGCTCCCATCCAACTGTCGGCGAGGAAAAGTTGTATATATTTAAAGC
ATGAGGTAACTTTGTTGCCCATTATCTTTTTTGTT
>MIT_Smik_c492_20940 YOR278W 5' untranslated region, Contig c492 3260 - 5259(revcom), 2000 bp (revcom)
ACTTTCAAACACACTCTGGTGTACTCCTCGGTCCCTTCATCTCATTTCTTCAAGATGCAG
AACTTCGCCGGAAGTAAACTAAAGTGCTTTAATTAATCAAAAGACAACTTAATTCCCAAA
CGGAAATGCAGGCTAGACAAACCGAAGATAATCCCCGATATTTCTGAGTTTAACAAATGT
ATGTATAATATGTATGCAATGTAGGCAAGAAAATAACGAAGTGAAGATATGTACACCTAG
AGCGAACCAATAATAATTTGTTTTCTTACTAAAGAAAAACTATTAAAACTGGATTAGATT
TCAATAATGAAAAGCTAGGAACAAAAGAAATTTGTCTACTTCCAGCCATTTGCGCTTTAT
ATAGACATATGGAGGCGTGATGTCTTAAGCATGGTAATCCGGAAGATCAGTTTATTGAAT
GATGGTTCTTTTAAACCAAAATTTAAAGAAAAATCTTAACGGTAATATGAGTAGGAGGTT
GGAATGGGATCGCTTTTTATACCCTCATTGTGATAAGAGACGCGCAGTGAAAAATTTTCG
CTTTTTCTTAGGGCTCCTATCTAACTCTCGGGCGAATAAATATCATGAATGTATTTAAAC
GTCAAGTTAGTTAAATGTTTGAGTCTGTTTCTTTT
>WashU_Scas_Contig692.36 YOR278W 5' untranslated region, Contig c692 73267 - 75266, 2000 bp (revcom)
ACAACAACAAATTCAATTTTTTGCCCAATCACCGCAATATAACCTTTTAACGGTTAACGC
CAGATAAAGTGACTTTGCCAATATAAATGATAGCATCAATTTTATTAGTTTTTAATATAC
AAAAAATGGTTTTCTAAATAATGATTATTCTAGAGATATTTTTATTATATGTAATGAGAA
TTTTATTTTATTTTATGTTTTGGTGATGAGGTTTATCTATTCCCATTCAACGGTAGCAGG
TGGCTTAGAAGTAATATCATATGTAACTCTAGCAACACCATCCACTTCATTGACGATTCT
AGAAGCAACCTTCTTCAAGAAGCTGTGTTCAAATGGATACCAATCAGCAGTCATGAAATC
AGTAGTTTCAATGGCTCTTAATGCAATAACTTGTTCGTAAGTTCTTTGATCACCCATGAC
ACCGACAGATTTAACTGGAAGTAAACATGCAAAGGCTTGAGAGATCTTATCATATAGACC
AGCCTTTCTAATTTCTTCAATGTAAATGTAATCGGCCTTCCTAGCAATGGCAACTTGTTC
CTTGGTAACTTCACCTAGGACACGAATGGCAATACCTGGACCTGGGAATGGATGTCTCCA
AACTAATTCGTGGGAGATCCCCAATAATTCACCTA
>WashU_Skud_Contig1682.4 YOR278W 5' untranslated region, Contig c1682 3379 - 5378, 2000 bp (revcom)
CTCTTCAAACAGACTCCAATTCACTACTGAGCTCTTACCTTGTGACTTCAAGACTCACTA
CTCAGTTGAAAGACACGCTCAGTACCAAATTCGGCTGCGAGGCAACTAACGCCTTTAAAC
AGGTAGGTAAGGAACAATACCGAAAGGCCATCTCCGATGTTTCGAAGATTGGCAAATGTA
TATATTATGTATGCAATATAGGCAAGATGATAACGAAGTAGAGATATGTACACCTAGAGC
GAACCAATGATAATTTGTTTTCTTAATGAAGAAAGTATTAAAACTGGATTAGATTTCAAT
AATGAAAAGCTAGGAATAAAAGAGATTGGTCTACTTCCAGCCATTTGCGCTTTACATAGA
CATATGGAGGCGTGATGTCTTAAGCATGGTAATCCGGAAGATCAGTTTATTGAATGATGG
TTCTATTTAAAATGAAATCTAAAGATAAACCCTAGTCATAATCAAGTGGGTTGTGTTAAA
ATACAAGCACCTTTTATACTCTCGCAGCGTCAGTGGCGCGTTGTGAAAAATTTTCACTTT
TTCTCAGGGCTTTTACCCAACTGCCGACAAATAAAAGCCGTATTTAAGGAATGTGATTAG
TTTACTTTCCAATGCTTTCTCTTTTTTGTAGGGTA
>WashU_Sbay_Contig635.57 YOR278W 5' untranslated region, Contig c635 91073 - 93072, 2000 bp (revcom)
ACGTACAGATGGCGTCTCCTCCTTTCGCGAGCCCCTTGCCTTGTGACTTCAGCCTAACTT
CTTGACTAGAAGATACAACAAGAAATACTCAAATCGGTTATTGTGCAACTCATCCCTCAG
ACAGTTTGGTAAGAAACACCGAAGACTATTTCCGATATCTCAAAGAATGACAAAAGTATA
CATTATATATGCAAGAGAGGCAAGAAAAGAGTAAAAAAGAGTAAAAAAAACATGTACACC
TAGAGCGAACCAGTGATAATTTGCTTCTCAATGAAGAAAAAGCGATTAAAACTGGATTAG
ATTTCATTAAAGAAAAGCTAGGAACAAAGAAATTGGTCTACTTCCAGCCATTTGCGCTTG
ACATAGACATATGGAGGCGTGATGTCTTAAGCATGGTAATCCGGAAGATCAGTTTATTGA
ATGATGGCTCTTTTAAATTGAGATCTAAAAGAAATATCCTGGAAAAGAGTAGAGAAGAGT
CCAAACTGTAGGAATTCAATCGCTTTTTATACTCTCATCGCGGAAAAGACGCGCTGTGAA
AAATTTTCTCTTTTTCTTAGGGCTCCTATCCAGCTGCCTGCGAACAAAAGCCGTATTTAA
AGCATGATTTTCACTACTATGTATGTTCTTTCTGC

