>SGD_Scer_YDR232W HEM1 "5-aminolevulinate synthase, catalyzes the first step in the heme biosynthetic pathway; an N-terminal signal sequence is required for localization to the mitochondrial matrix; expression is regulated by Hap2p-Hap3p"
ACTGAAAAAAAAACCTAAGTACTGTTATGATTATTGAGGGACAACAACTAGCTCTATTAG
TTTTCCTTCCAACCAAACTTATATGGGCAATATATAGGAAAGAAAAAAGAAAAGAGTGGG
ATAAAAAAAAAAGAAACGCGAGCTGAGAAGGGAAGGCGTGTAAAGGAAGAACGGTTGAGA
GACAGCAGAGCAGGGTGCAACACACAACCGAATAGAGTATCAGCTGACGGAATGGAGAAG
TTTGGTATGATGCAAACGTTGTATTTCTAACAACGCATGGATCAGAACAATGGGCAAGGC
AAGATGAAAAATTTCCGTTCCTGCTCTTTCTTCATATATGAACAATGACCAAAAAGCGCC
CGCGGCCGCAGACCAATGAGCGACGAAGGCGGCCTTTCCGAGCGGTAGGGTAAGCCGTGC
AGGCAAGCTTATTATAGCACCGTCGGGGGTACCACCACTATATCAAACTCCACTGCTCGG
TAAAGCATTGTAGTGAAG
>MIT_Spar_c117_4603 YDR232W 5' untranslated region, Contig c117 17441 - 19440, 2000 bp (revcom)
ACTGAAAAAAAACCAAGTACTGTTGTGATTATTGAGGGACAACGGCTAGCTCTATTTGTT
TTCCTTCCAACCAAACTTATATGGGCAATATATAGGAAAGAAAAAAGAAAAGAGTAGGAT
AAAAAAAGAAACGCGAGCTGAGAAGAGAAGGCGTGTAAAGGAAGAACGGTTGAGAGAGAG
CAGAGCAGGGTGCAACACACAACCGAATAGAGTATCAGCTGACGGGATGGAGGAGTTTGG
TACGATGCAAACGCTATATTTGTAGCAACGCATGGGTCAGAACAATGGGCAAGGCAAGAT
GAAAAATTTCTGTTCCTGCTCTTTCTTCATATATGAACAATGACCAAAAAGCGCCCGCGG
CCGCAGACCAATGAGCGACGAAGGCGGCCTTTCCGAGTGGTAGGGTAAGCCGTGCAGGCA
AGCTTATTATAGCACCGTCGGGGGGACCACTATATCAAGTTCCACAGCACGGTGAAGCAT
TGCAGTATAGTTCACAGC
>MIT_Smik_c228_4055 YDR232W 5' untranslated region, Contig c228 4702 - 6701(revcom), 2000 bp (revcom)
ACCGAGAGAAAAACTAAGTAGTGATATGATTATTGAGGACTAATGACCAGCTTTGTTTGT
TTTTTCTTCCAACCTAACTTATATGGGAAATATATAGGACAGAAAAAAGAAAAGAGCACG
AAAAAAAAGAAATGCGACCTGAGAAGGGAGGACGTGTGAAGCCAGAACGGTTGAATGACA
GTAGAGGAGGGTGCAACACAACCGAGTAGAGTACCAGCTGACGGAATGGAGGAGTTTGGT
ATGATGCAAAAGTGATGCTTTTAGCAACGCAACATTGAATTAGAACAATGGGCAAGGCAA
GATGAAAATTTCCGTTCCTGCTCTTTCTTCATATATGAACAATGACCAAAAAGCGCCCGC
AAGCGCAGACCAATGAGCGACGAAAGCGGCCTTTTGAAGGGTAGGGTAATCCATGCAGGC
AAGTTTATTATAGCACCGTCGGGGGGAAGCATTATATCAAACTCCACAGTACAGCGTAAC
ATTGCTGTATAGGCTACA
>WashU_Scas_Contig721.76 YDR232W 5' untranslated region, Contig c721 147634 - 149633(revcom), 2000 bp (revcom)
TGTTTGTGAAGCAGACGGGTGGATAGAGCGGCCAGCGAGCAAGCAAGTATAGACTAGATT
TGTTCTGTTCTGTTTGAGATGAGCTGAGCTGATGTGATGATGTGATGTGTTGTTATATAC
AGTGCTGTATATATGAATAATTGTTAAACGACGGGATTGGCGTGTTACGTAAGGAAAATA
GAGCTTTGAGCAAAAAAGAAAGGCGCGCTCAGAAACTGCCGCACACAGCTTTTGGGCCAA
TCAGAAGACGGGATTTGGATCTGGCACGTGATTTGTCGTGTTTGGTGACAGGCTGTTTGT
TACCCAGCTCTTTTGATTTTTTTGATTTTAGCCGCCCAATTCAGTTTCCCCTTCTTCTTC
TTATTGAGCTGTATATACGGGGAATACAACAACAACAACAACTACTGCTACTACTACAAG
ATCTACATATACAATGGGCTGGCTACCATCCTTCAAAAGCAACAGCACACCGCAGCAGCA
GCAGGAACCCCAGCAGGA
>WashU_Sklu_Contig2308.6 YDR232W 5' untranslated region, Contig c2308 6692 - 8691, 2000 bp (revcom)
CCCTTCTTCGTCTGTCTATTTTTCGACGGTTCTATTCCTGTAAAGAGGGGAGGTGAGTCT
TCTCTCCACTACTCACATACATATATATATTTATTTTTTTCTTCCCATCCAATAGGAAAA
AAGAAATTTTCTGAAAAATTTTTAGGTGTGATCAAGTATGTGATCACGTGGACAGTTGCC
TGAGCCAATAAGAACGACGTTAAAGCTAATGTTAGGTGTTACTTACGAGCTATTCAGTTC
GCGATACCTGTCTTGAGCCTTTGGATGCCCCATTTGAGCAGCACATTTATAATGTTCCAG
AGCCTTGCTTGGATCCTTTGTGCAGCCAATACCGCGCTCGTAGAAGAAAGCTAACGCATA
CTCTGCGCGGGCAAACTTACCTTCTGTGGACTGGCAGCTCCTTAAAGCCCAGCTGAATGC
CTCTTGGTCGTTCGGCTGTAGAACACCAGCAGCACCTGTAAGATACCATCCACTCAAAGC
CATCATCGCCATCGGGTT
>WashU_Skud_Contig2069.5 YDR232W 5' untranslated region, Contig c2069 5476 - 7475, 2000 bp (revcom)
ACTGAAAATAATCCGAGTCGTGCTACTGTGAATATTGAGAATAGGGACTAGCTCTATTTG
ATTTTTCTTCCAACCAAACTTATATGGAAAATATAAAGGAAAGAAAAAAGAAAAGAATAG
GAAAAAAAAAAAGAAACGCGAGAGAAGAGAACCGTGTGGAGGGAAGAACGGTTGAGAGAC
AGCAGAGCACAGCGCAACACAACCGAGTAGAGTACCAGCAGACGGAGTGGGTAGTTTGGT
ACAGTGTAAAAGCTATATTTCCACCAACGCAACACTGGATCGGAACAATGGGCAAGGCAA
TGTGAAAAATTTCCGTTCCTGCTCTTGCTTCATATATGACAATGACCAAAAAGCGTCCGC
GGCCGCAGACCAATGAGCGACGAAGGCGGCCTTTCGTAGCAGCAGGGTAAGCCGCGCAAG
CAAGTCCGTCATAACACCGTCGAAGGGGCACCACTATATCAGCTCTTCAGCATGGTAGGC
CATTACAGCACAGTCTTG
>WashU_Sbay_Contig461.5 YDR232W 5' untranslated region, Contig c461 4000 - 5999, 2000 bp (revcom)
ACTAAAAAGTCCAAGTGGTGCTGTTATTATTGAGGATAGCAACTAGCTTTATTTGTTTTT
TCTTCCAACCAAACTTATATGGAAATCAAAGGAAGGAAAAAAAGAAAAGAACAGGAAGAA
AAAAAAGAAACGTGAGCTGCCGAAAGGAGAGCGTGTGGAGGGAAGAACCGTTGAGAGACA
ACAGAGCAGGGTGCAAACCGATTAGAGTACCAGCAGACGAGATGGGCGATGTGGTACGGT
GCAGAAGGTGTGGTTCCAACAGCGCAGCACCGGGACAGAACAATGGGCAAGGCAAGATGA
AAAATCTCCGTTCCTGCTCTTGCTTGATATATTAACAATGACCAAAAAAACGCCGGCGGG
CGCAGACCAATGAGCGACGAAGACGGCTTTTGGGCGGGGCAGGGTAAGATGGGACAGGCA
AGGTCCGCTATAGCACCGTCGAGGGGGACCGCTATATCAGCTCCCAGTACATTGCAGCAC
ACTCTATAGCTAGTCAAA

