>SGD_Scer_YER014W HEM14 "Protoporphyrinogen oxidase, a mitochondrial enzyme that catalyzes the seventh step in the heme biosynthetic pathway, converting protoporphyrinogen IX to protoporphyrin IX"
TATACAAGCTCTTTTTGGCGTTCTCAATTGCACTTTACTCGATATGTTTGAATTGGTGTT
CTTCGCGAATATCTCTATTGTTCTCTCTATTATACTATTTCTTTTTTTGAATACTCCGCG
ACTCCGAAGCAACAAAGTGTCGAAGGCAAGTTCAAAGGCGTTTTGTAACTAAACGAGCAA
TGGCAGCTTTCAATTAAAGAAAGGTTAGCGTTACTCTGTGATTTTTTTCATGTAAAAATT
CTCAAGAGAGATAAAGTTGTTAAAAAATTAAATATAGGTCTATAAAACTCGATAATTATA
ATGCATAAAAAGCTAACAATGT
>MIT_Spar_c425_6072 YER014W 5' untranslated region, Contig c425 34016 - 36015, 2000 bp (revcom)
TATTCGAGCCCTTTCCCGCGTTCCCAATTGTACCTTCCTCGATAGGATTGAATTGGTATC
CTTCGCGGATCTCTCTATTGTTCTCTCTATTATTCTTTTTCTTTTTTAAATACTCCGCGA
CTCCGAAGCAACAAAATGTCGAAGGCAAGATGAAAGGCGTTTTGCAACTAAACGAGTAAT
GGCAGCTTTTAATTAAATAACGGTCAGCATTACTCTATAACTTTTCACATAAAATCCTCG
AAGAAGGAAAAATTGATAATCAATTTACCGAAGAATGAATATAGGTCTATAAAAATTCAA
TAATTATAGATGCATAAAAAGC
>MIT_Smik_c283_5928 YER014W 5' untranslated region, Contig c283 42606 - 44605, 2000 bp (revcom)
TATTGAAGCTCTCTCCACTATTTCTTTAATCGCGCTATACTAGATATGGTTAAACTGCTA
TCTTTTGCAAATCCCTCTATTGTTCTTTCCATTACTCTTTTCTTTTTTAAATACGGACTC
CGAAGCAACAAGGTCGAAGGCAAGCTGAAAGGCATTTTACAACTAAACGAGCAATGGTAG
CTTTTGATTGAATAAATTATTATCATTATTTTGTTATTTGTCCCACGAAATTCTCGTTGA
AAGCAAGGTTCGTAAGGATTTATCAAATGTTAAATATAGATCTATAAAAATTGAATAGTA
ATAATAACAAGGGATGGTGTTA
>MIT_Sbay_c84_6418 YER014W 5' untranslated region, Contig c84 10802 - 12801(revcom), 2000 bp (revcom)
TGTCGAAGTTCTCCTTTATTCCGCTGTTTCTTACGGAATCCAGCGAGACTGTTGTCCTTT
CGCATCCTTCTATTGTTCTTCCTTATTGTTCTCGTTTTTTTTATACTCTGCGACTCCGAA
ACAACAAAATCTCGAAGGCAAGCTAAGGTAAAAATATTCACCACTAAACGAGCAATGACA
GTTATATTCAAACGTCATTCTACTTTTTTGCCAGAGAAGTCCTCACTGGAGACGAAGTTG
GTAAATGCTTTATTTATATTAAACGTAGATCTATAAAGTTTAAATAGTTTATAATGCTTA
ACAAGGGACGATGTTATCTCTT
>WashU_Scas_Contig614.8 YER014W 5' untranslated region, Contig c614 13890 - 15889(revcom), 2000 bp (revcom)
CTGATTCAATTGTTCGTGTGTATGTTCTTGAAAGCCCTTGCAACGGTGTTCAGGTTGTTC
TGATTCTTCTCCCTGTTTATGTGCTGCTGTCTCGAGAAATGAAGACACATTTTTCAAGAT
CCGAAGCTTATACGATTCTCACGGGACAAACAATGGGCGTTTCATATGTAGACAATTTGC
AAGTCAAAAAGAACGCCAATCTTTCACCAGAATATATTAATATATGAAATATATATGTGC
CTATAAATACTACCTTTTGACACCCAATGCTCTTTCTCTTGATTGTCTAATGGAACTTAA
CCTCCAAGAATTTTGATCTTTA
>WashU_Sklu_Contig2060.2 YER014W 5' untranslated region, Contig c2060 550 - 2549, 2000 bp (revcom)
TGAATACACTTTACTACTTCACCTTTTCGTACTTTCAATAGTTTGTAATTCAATCGTTTG
CAAATACTATGTTTCCTTTTTTTTTTTTCACCATTCCGTCATTACACTCCTATACGAGAA
ATACATACTAAAATAAAAAAAAAAAAAAAAGCTTATGTAATCTATCTCTTGATACCCAAA
GCTCTTTCCTTTGACTGTCTGATGGAGCTCAACCTCCAAGAGTCCTGATCCTTTGCAAAC
TTGTTGTGAAGAGGAACGATCTTAGCCTTTTTCCTGCTTTCACTATCTGCACCTGCAACT
TTATAATAGTGAGGAGCACTTT
