>SGD_Scer_YDL205C HEM3 "Phorphobilinogen deaminase, catalyzes the conversion of 4-porphobilinogen to hydroxymethylbilane, the third step in the heme biosynthetic pathway; localizes to both the cytoplasm and nucleus; expression is regulated by Hap2p-Hap3p"
AGTACGTGTGTATTTACCAACTACAAATTTATCTAGATTTTCTTCGCTTTTCTTTTTTTC
TATTGTTCTAGATATTAATACGGGATGAGAAGAACAGAATATTCAAAATCTAATACAGCC
CTGTACCATGCAAACACGAGCGTCAATCTGCCAATGACCTTGAATTCAGGCTATGTGTAG
CAATAATACAGATAGTTAGTAGCCTCGTTTATATAAAGCGTTCCTTTACTTTTTCATTTT
CTTTCTTTTTTTATGTTTGATTTTTTTACTTTTTCACTTTAAAAAATTGCTGAAATTTTC
GTAGCCAAAAAAAAGACCTTCATTGCTTACTCATCGGTTTCTTATTGGTCAGACGCTCCC
CAGGGTCAATTGACAAGGAGAGAAGGAATGTTATATGGGAATTGCTGCGTAAAGATGGTC
AAAAATCCTGGACTGCCGTACGAACGACAATGTAAGGATGACTGCATTAGCCAGAAAGAC
ATCTTTACCCCCGGTGCTGCCAGGGAGCAAAATAATTACGAAAAGTGGACGCAAAGTTAA
CTTAAACTACAAGGGTAGCAGCAGAATGTGTCGGTGGTACCGGTGTGATAATGCCCCATT
TGAGATGCTTGTAATTGTGGCCTAGCAATAAGAACGCAAGGCGTTTTTGTTGAAAGGAGA
ACAAGGTTAGACGGTGACGTTTAGGCGCATAGGCAATCTCCCCTTATTGTTCACCCTTAT
TTCCACCCTCAAACGATAAAGCTTGCTACTTTGATGAAAAAAATATATAAAAGGGATTGA
AAAGCAGATCAATTATGTAGCAATAGTAGTAATAACTTGTTCAATTGCTTGTCTCAACTT
GCCACAAACTATCATCAACA
>MIT_Spar_c429_3020 YDL205C 5' untranslated region, Contig c429 77420 - 79419(revcom), 2000 bp (revcom)
AGTACGTGTGTATTTATCAACTACAAAATTTATCTAGATTTTCTTGCCTTTTCCTTTTTC
TATTGTTCTAGATACTAATACGGGATGAGAAGAACAGAATATTCAAAATGTAAAACAGCC
CTGTACCATGCAAACACGAGCCTCAATCTGCCAATGACCTTGAATCCAAGCTATGTGTAG
CAATAATACAGATGATTGATTGGCGTCGTTTATATAAAGCGTTCCTTCATTTTTTTCATT
TTCTTTCTTTTTTTATGTTTGATTTTTTACTTTTTCACTTTTGAAAACTGCTGAAATTTT
CGTAGCAAAAAAAAAAAGACCTTCATTGCTTACTCATCGGTTTCTTATTGGTCAGACGCT
CCCCAGGGTCAATTGACAAGGAGAGAAGGAATGTTACATCCAGGAATTGCGACATAAAGA
TGTCCAAGAAGTCTGAACTGTCATACGAATGGCTATGCAAGGAGGATAGTACTGGTCAAG
AAGACATCTTACCCCCGGTGCTGTCAGGGAGCAAAAAAATGACAAAAGTGGACGCAAAGT
TAACTTGAACTACAAGGGTAGCAACAGAATGTCGGTGGTACCGGATGTGACAAAGCTCAC
TTGAGGTGCTTCTTGTTGCGGCATAGCAATAAGAGCGCAAGGCGTTTTTATGGAAAGGAG
AGCGAGGTTAGAGGGTGACGTTTAGGCGCATAGGCAACCTCCCCTTATTGTTCACCCTTA
TTTCCACCCTCAAACGATAAAGCTTGTCTACATTGATGAAAAAAATGTATAAAAGGGATT
GAAAAGCCGATCATGTGTGTAGCAATAGTAGTAGTTATACTTGTTCAATTGCTTGCTTGC
ACTTTTCCAAAAACTACCAC
>MIT_Smik_c193_2483 YDL205C 5' untranslated region, Contig c193 6380 - 8379(revcom), 2000 bp (revcom)
AGTACGTGTGTATTTACCAACTATAAAATTTTACCTAGACTATCTGGCCTTTTTCTTTTT
TCTATTGTTCTAGATACTAATACGGGATGAAAAGAACAGAATATTCAAAAAGTAATACAG
CCCTGTACCATTCAAACACGAGCGCCAATTTGCCAATGAACTTGAAATCCAGCTATGCGT
AGCGATAATACAGATGATTGTTTGATGTCGTTTATATTAAGCGTTCCTTCAGTTTTTCTC
ATTTTCTTTCTTTTTCTATGTTTTATTTTTCACTTTTTCACTTTTGAAAATTGCTGAAAT
TTTCGTAACAAAAAAAGAGGCCTTCATTGCTTACTCATCGTTATCTTATTGGTTAAAATC
CCCAGCGACAATGTACAAGGAGAGAAGAAATGATATGTCTGGGAATTGCAGTTTGAAGAT
ATCCAAAGAGTTTTGAAGTGCCATACGAGCAACCACGTGAGAAGTAGAGCCTTAACAGAA
AATTCATCTTACCCCTAGTACTGCCAGGGAGGAACTAAACCTAAGAACTAGTGTTAACTT
GACTTGAACTGCAAGGGTAGCGACGGCGTATGTCGGTGGTACCGGATATGGCAAGAGCCC
ATTTGAGCTGCTTGTTCTTGTGACATACTATTAAGAGCGCAAGGCGTTTATGGAAAGGAG
GACAAGGTCAGAGGATGACGTTTAAGCGCATAGGCAATCTCCCCTTATTATTCACCCTTA
TTTCCACCCTCAAACGATAAAGCTTGCTGCGCTGTTGAAAAGTATATAAAAGGGATAGAA
AAGCAGAGCAATTATAATTTAGTAGAATAGCTTATTCTATCGTTAACTTGTTGAAAGGAT
CAGATTATTATCAAGATGAA
>MIT_Sbay_c841_3215 YDL205C 5' untranslated region, Contig c841 7323 - 9322(revcom), 2000 bp (revcom)
AGTATGTGTATATTTACCAACTATAGAGTATATCTAGTATTTTTTTTCCTTCTTCTTTTT
CTATTGTTCTAGATGCTAATATGGGATGAGTAGAACAAAATATTCAAAACGCAATACAGC
CCTGTACCATTCAAATACGAACGCCAATCTGCCAATGACCTTGAAATCAAGTTATGTGCC
GCGATAATACAATCTTTTGGCCTATATCGTTTAAATAAGCGTTCCTTTAATTTTTCGGTT
TCTTTCTTTTTTATGTCTAATTTTTCATTTTTTTTCACTTGAAAATTGCTGAAATTTTCG
TAGCTGAAAAAGAGAGGCCTTCTTTGCTTACTCATCGTTATCTTATTGGTCAAGAGCCCA
AGGGACAATAGACAAGGAGAGAACCACCAACTTTGGGAGTTGGATGCAAAGAAGGTCTTT
GATTTTGGGCTGCTATCAGAGCGGGCCATATAAGGAAGCTTGTAGTGGTTAGGAGAGAAC
ACGTCATTACCCCCCTCCCCCTTCTCCGCGCTGCCAGGGACCAGGCAAGGGCTTGCAAGA
GATGAACGTAAGATAGAACTACGAGGGTCGCGGCCAATGTGTCGGTAGTACCGGATGGGG
CAAAGCCCAATTGAGGTGCTTGTTGTTGAGGATGGTCGGCATGGCATGGCATGGGAGGCC
AAAGGCGCTTTGTGGGAAGGAGAACAAACAACATTAGAGGGTGACGTTTTAGCGCATAGG
CAATCTCCCCTTATTGTTCACCCTTATTTCCACCCTCAAACGACAAGGCTTGTTATGTTG
GTTGGAAATATATAAAAGGGATTGAAAAAGATCATATTCCTACATAAATTATGGTATTAG
TTTTTCTTCAATTGCTGGCT
>WashU_Sklu_Contig1799.3 YDL205C 5' untranslated region, Contig c1799 4415 - 5133(revcom), 2000 bp (revcom)
TTCTCTTAATAATATTACACTATGCGTATTCTCTCTGTTTCAAAATAAAGTCGATAATAA
AAACCAGAATGTAAAACCCAAAAATTACTAATAATAAACCAGGAATAAAATATGTACAGG
ATGAAAGGTGGAATAATATTTACAGCGACTTGTTCATGCAATGGCGACCAGGATGCAAAT
GCAGCTTCAAAAGGTTTTCGAATGCGGACTGATGTCTTGAAGAAGTAATAAGTGGGAAAC
GCTAAAGAGCGAGCAAATACAAGTTAAAAGGAAATGCTGGATAAGCCTGGTAACCAACGG
TAATACAACAAGCTGTATAAATACCTTCTGCCGAATGAGTTCTTTTTGATAGAAAAGATA
ACTAGGAAAAAAATTGGAAAATTTTTCAGCTGGAACCAATTATCAAAGTTCTGATTACTT
CACCGATCAGGGTAACGGCGTGTCTGACTAACAGGAACGGCCAATAAAAAAGGTGTAATT
AGTAGCAAATAAATAGATAAATAAATAACTGTGCGTTTAAAATATTATACAGTCTAGCGT
TGTTTTTTTTTTTTCGTTTCTTATTCCTCATAGTTGAGACTTAACCCAGCCTTCCAAACC
GCCCTTGACGATAATTTCTTGCAGATTCTTACCCAACTCGCCGACTTTCTGTTGGTGAAN
CGACAGATCCATCTAGCGTTTTTTGAATGAATTCCACCACATGGAGCTCAGCGCTGAGA
>WashU_Scas_Contig562.6 YDL205C 5' untranslated region, Contig c562 13955 - 15954(revcom), 2000 bp (revcom)
GGTTTGCAGTGTTCAAGGAGAAAGCTGACCAGCAGTAAAATTTTAGTGTGATGGCAGTGT
CAGCTTTATACGTGGCAATTGCTGATCGTTACCTATCAATGTTTCAACTTGAATTAAGTG
TCAGATTTGAGAATTTAACCATATTACTCGACCAATTGTTGCGGCAAAGTTGAGATGGCA
CAGAAACTACCGCAGAGAAGTAGGGTTACAGATTTTATACGATGAACGATCACTTTCTAA
ATTAGGGCTTGCATTACCAGGGCTTTAAAATCATTTTACACGGCCTTTAGGGCTTGCGAC
AATAGATGAACGGCTGTTTGATGCATTTCTTTACATGAAATTTCTCTTGGCAAGGTACTT
TATTATTTCCCCTTCAAAATGGATGGATGTATATACTTCTTGTTCATATATATATAGGGA
AGGGTTGCGGTCAGGTTCATACAGTATTACTTCCCTCTTTTTCCCTCAAAAATGGCCACG
AAATAAAGATGATGGAGTCACATTTTCAATCAGATGTCCCTACACACAAACCATCCAAAT
ATGCAAACTTGAATAAATTGGAAAGTCTAATCTATTGGAGACACCCTCAAAGGTCAGCCA
AATAATTTACAGCCACCTTATTTACCCTCATCTTCTTCAAGATGATCAATCCGGTGACTT
TCTTTTTAAAAATAGGCTACACTGTCTTATTCATTACTTCATTGTTAGAATTTATCACCA
GTTTAACCCTGGGGAAGGGGATAAGGACCCAAATGGCACCACAGGTATGTCCGGACATGG
TAAGGTACATAGAGCCAAGGGTCAACTCCATCCTGGACACAATTCCACCCTTACAGCAGG
GCCTAAGACGTTTGGTGTTT
>WashU_Skud_Contig1850.5 YDL205C 5' untranslated region, Contig c1850 6875 - 8874(revcom), 2000 bp (revcom)
GATACGTGTGTATTTGCTAACTATAAAATTTATCTAGTTTTCCTGCTTTTTTTTTTTTCT
ATTGTTCTAGAAACTAATATGGGGATGAGAAGAACAAAATTTTCAAAAAGCAATACAGCC
CTGTACCATTCAAACACGAACGCCAATCTGCAATGACCTTGAAATCAATCTATGTGTCGC
GATAATACAAGTGATTGATTGGTGTCGTTTATATAAAGCGTTCCTTCAATTTTTTCATTT
TCTTTCTTTTTTTATGTTTAATTTTCTACCTTTTTCACTTTTGAAAATTGCTGAAATTTT
CGTAGCAAAAAAAGAGAGGCGTACGTTGCTTACTCATCGTTTTCTTATTGGTCAAAAGCT
CCAGGAACAATGCCCAAGGAGAGAAAGAGTGCTACGTCTAGGAATTGCGATGGAAAGGCG
TCCAAGAGTCCTAAACTACCATGAGAACGGGCCACCCAAGGAGGGATAGCAATTGCTGAA
ACAACATCTTCACCTTCGGAGCTGGCAGGGAGCAAGGGACTCTCCGGAAAGAAAGTGAAC
GCAAAACGGAACTACAAGGATAGCAACGGAATGTGTCGGTGGTAGCGGATGTGGCAAGAT
CCCATTTCAGGAGCTTGTTGTTACGGCACAGCAGCAAGAAGAGCACAAGGCTTTTTCCGT
AAAGGAGAACAAAGTTGGAAGGTGACGTTTAGGCGCATAGGCAATCTCCCCTTATTGTTC
ACCCTTATTTCCACCCTCAAAGGATAAAGCTTGTTGCATTGATAAAAAATGTATAAAAAG
GATGGGAAACAGATGATAGTTAACAAGGTAGTGGGACGGTCTTTCGCTTATTCAGTTGTG
TGACATTCAAGGGTTACAAT
